#start
-------------
-f-       -f-
- - -- -- - -
-    - -    -
-- -     - --
-- - --- - --
-     -     -
- --- - --- -
-   -   -   -
- -   -   - -
- --- - --- -
-f    -    f-
-------------
#end