foods=12
#start
--------------------
-   -          -   -
- - - ---- --- - - -
- -   -      - -   -
-   - - -- - - -- --
- ---   -  -      --
-   - - ---- - -- --
- -   -      - -   -
- - - --- ---- - - -
-   -          -   -
--------------------
#end